****XXXXXXXXXXXXXXXXXXXXXXXXXXXXXXXXXXXXXXXXXXXXXX
*****XXXXXXXXXXXXXXXXXXXXXXXXXXXXXXXXXXXXXXXXXXXXX
*******XXXXXXXXXXXXXXXXXXXXXXXXXXXXXXXXXXXXXXXXXXX
XX**X***XXXXXXXXXXXXXXXXXXXXXXXXXXXXXXXXXXXXXXXXXX
XX*****XXXXXXXXXXXXXXXXXXXXXXXXXXXXXXXXXXXXXXXXXXX
X***X*XXXXXXXXXXXXXXXXXXXXXXXXXXXXXXXXXXXXXXXXXXXX
X******XXXXXXXXXXXXXXXXXXXXXXXXXXXXXXXXXXXXXXXXXXX
X******XXXXXXXXXXXXXXXXXXX****XXXXXXXXXXXXXXXXXXXX
X**XX**XXXXXXXXXX*******XX*X*X**XXXXXXXXXXXXXXXXXX
****XX*XXXXXXXXX***X*X*******X***XXXXXXXXXXXXXXXXX
****XX***XXXXXXX*XXXXXXXX**********XXXXXXXXXXXXXXX
*XX**X***XX**XX***XXXXXXX****XXXXX*****XXXXXXXXXXX
***X*XX**********XXXXX*XX****XXX**X*XX*XXXXXXXXXXX
XX*X********X***XXXXX****XX***XX**X**X***XXXXXXXXX
XX***XX*X*******X*XXX*********X**********XXXXXXXXX
X***XXXX*****************XX*****************XXXXXX
XX*XXXXXXXXXXXXXXXXXXXXXXXXXXXXXXXXXX**X*****XXXXX
X**XXXXXXXXXXXXXXXXXXXXXXXXXXXXXXXXXXXXX**XX*XXXX*
X*XXXXXXXXXXXXXXXXXXXXXXXXXXXXXXXXXXXXXXXXXX*XXXX*
X*XXXXXXXXXXXXXXXXXXXXXXXXXXXXXXXXXXXXXXXXXX**XX**
X*XXXXXXXXXXXXXXXXXXXXXXXXXXXXXXXXXXXXXXXXXXX*****
X***XXXXXXXXXXXXXXXXXXXXXXXXXXXXXXXXXXXXXXXXX*****
XXX**XXXXXXXXXXXXXXXXXXXXXXXXXXXXXXXXXXXXXXXXXXX**
XXXX*XXXXXXXXXXXXXXXXXXXXXXXXXXXXXXXXXXXXXXXXXXX*X
XXXX***XXXXXXXXXXXXXXXXXXXXXXXXXXXXXXXXXXXXXXXXX**
XXXX*XXXXXXXXXXXXXXXXXXXXXXXXXXXXXXXXXXXXXXXXXXX**
XXXX**XXXXXXXXXXXXXXXXXXXXXXXXXXXXXXXXXXXXXXXXXX**
XXXXX*XXXXXXXXXXXXXXXXXXXXXXXXXXXXXXXXXXXXXXXXXX**
XXXXX***XXXXXXXXXXXXXXXXXXXXXXXXXXXXXXXXXXXXXXXXX*
XXXXX*XXXXXXXXXXXXXXXXXXXXXXXXXXXXXXXXXXXXXXXXXXX*
XXXX*****XXXXXXXXXXXXXXXXXXXXXXXXXXXXXXXXXXXXXX***
XXXXXX***XXXXXXXXXXXXXXXXXXXXXXXXXXXXXXXXXXXXXX***
XXXXXX***XXXXXXXXXXXXXXXXXXXXXXXXXXXXXXXXXXXXXX***
XXXXXXXX***XXXXXXXXXXXXXXXXXXXXXXXXXXXXXXXXXXXXX**
XXXXXXXXXX**XXXXXXXXXXXXXXXXXXXXXXXXXXXXXXXXXXX***
XXXXXXXXXX*XXXXXXXXXXXXXXXXXXXXXXXXXXXXXXXXXXXX***
XXXXXXXXXX*XX*XXXXXXXXXXXXXXXXXXXXXXXXXXXXXXXXXX**
XXXXXXXXXX****XXXXXXXXXXXXXXXXXXXXXXXXXXXXXXXXXX**
XXXXXXXXXXX****XXXXXXXXXXXXXXXXXXXXXXXXXXXXXXXXXX*
XXXXXXXXXXX***XXXXXXXXXXXXXXXXXXXXXXXXXXXXXXXXXXX*
XXXXXXXXXXXX**XXXXXXXXXXXXXXXXXXXXXXXXXXXXXXXXXXX*
XXXXXXXXXXXX**XXXXXXXXXXXXXXXXXXXXXXXXXXXXXXXXXX**
XXXXXXXXXXXXX*****XXXXXXXXXXXXX**XXXX****XXXXXXX**
XXXXXXXXXXXXXX****XXXXXX*X**X**********X*XXXXXXXX*
XXXXXXXXXXXXXXX*X******************X***X*XXXXXXX**
XXXXXXXXXXXXXXXXXXXXXXXXXXXXXXXXXXXXXXXXXXXXXXX***
XXXXXXXXXXXXXXXXXXXXXXXXXXXXXXXXXXXXXXXXXXXXXXXX**
XXXXXXXXXXXXXXXXXXXXXXXXXXXXXXXXXXXXXXXXXXXXXXXX**
XXXXXXXXXXXXXXXXXXXXXXXXXXXXXXXXXXXXXXXXXXXXXXXX*X
XXXXXXXXXXXXXXXXXXXXXXXXXXXXXXXXXXXXXXXXXXXXXXXX**